Derechos	derechos
Debe	debe
Constitución	constitucion
Respeto	respeto
ser	ser
Igualdad	igualdad
protección	proteccion
personas	personas
participación	participacion
sociedad	sociedad
País	pais
social	social
ciudadanos	ciudadanos
salud	salud
poder	poder
desarrollo	desarrollo
Libertad	libertad
Naturaleza	naturaleza
Gobierno	gobierno
instituciones	instituciones
Educación	educacion
humanos	humanos
conservación	conservacion
comunidad	comunidad
deberes	deberes
acceso	acceso
Ley	ley
Democracia	democracia
deber	deber
género	genero
Vida	vida
bien	bien
valores	valores
forma	forma
principios	principios
responsabilidad	responsabilidad
Justicia	justicia
constitucional	constitucional
cumplimiento	cumplimiento
medio	medio
garantizar	garantizar
Pueblo	pueblo
calidad	calidad
cultural	cultural
comun	comun
Persona	persona
tener	tener
decisiones	decisiones
tambien	tambien
Patrimonio	patrimonio
ejercicio	ejercicio
autonomía	autonomia
ambiente	ambiente
responsabilidades	responsabilidades
recursos	recursos
Leyes	leyes
fundamental	fundamental
valor	valor
principio	principio
proceso	proceso
regional	regional
constituyente	constituyente
vivir	vivir
digna	digna
soberanía	soberania
sociales	sociales
solidaridad	solidaridad
Chile	chile
seguridad	seguridad
ciudadanía	ciudadania
respetar	respetar
descentralización	descentralizacion
Congreso	congreso
normas	normas
declaración	declaracion
promoción	promocion
sistema	sistema
institución	institucion
histórico	historico
ciudadano	ciudadano
nacional	nacional
promover	promover
fundamentales	fundamentales
Asamblea	asamblea
política	politica
pública	publica
nueva	nueva
pueblos	pueblos
iguales	iguales
ciudadana	ciudadana
universal	universal
equidad	equidad
servicio	servicio
político	politico
vivienda	vivienda
medioambiente	medioambiente
obligaciones	obligaciones
expresión	expresion
políticas	politicas