abaj	abajo	abajo
abandon	abandonados	abandonados
abarc	abarcar	abarca,abarcando,abarcar
aboc	abocados	abocados
abog	abogado	abogado
abolicion	abolición	abolición
abord	abordar	abordar
abort	aborto	aborto
abrir	abrir	abrir
absolut	absolutización	absolutas,absolutización,absoluto
abstencion	abstención	abstención
aburr	aburrida	aburrida
abus	abusivo	abuse,abusivo,abuso,abusos
aca	acá	acá
acab	acaba	acaba
academ	académicas	académicas
acat	acatarlos	acatar,acatarlos
acc	acceder	acceder
acces	accesibles	accesibles,acceso
accesibil	accesibilidad	accesibilidad
accident	accidente	accidente
accion	acción	acciones,acción
acepcion	acepciones	acepciones
acept	aceptación	aceptación,aceptando,aceptar
acerc	acerca	acerca
acerqu	acerquen	acerquen
acord	acordamos	acordamos,acordar,acorde,acordes,acordó
acos	acoso	acoso
acostumbr	acostumbren	acostumbren
actitud	actitud	actitud
activ	actividades	activa,activamente,actividad,actividades,activo
acto	acto	acto
actos	actos	actos
actu	actuaría	actuando,actuar,actuaría,actúa,actúe
actual	actualización	actual,actuales,actualidad,actualización,actualizarse,actualmente
acuerd	acuerdos	acuerdos
acuerdon	acuerdono	acuerdono
acus	acusación	acusación,acusado
adan	adanos	adanos
adapt	adapta	adapta
adecu	adecuado	adecuadamente,adecuado
adel	adelante	adelante
adem	además	además
adicion	adicional	adicional
administr	administración	administraciones,administración,administran,administrativa,administrativas,administrativo,administrativos,administre
adn	adn	adn
adolec	adolecen	adolecen
adolecent	adolecentes	adolecente,adolecentes
adolescent	adolescentes	adolescente,adolescentes
adopt	adoptado	adoptado
adquir	adquirido	adquirido,adquiriendo
adquisicion	adquisiciones	adquisiciones
adquisit	adquisitivo	adquisitivo
adscrib	adscribe	adscribe
adult	adultos	adultos
afan	afán	afán
afect	afectan	afecta,afectan,afecte,afecten
afil	afiliarse	afiliarse
afirm	afirma	afirma
afric	áfrica	áfrica
agent	agente	agente
agot	agotar	agotar
agreg	agregamos	agrega,agregamos,agregan,agregar,agregarla
agrup	agrupación	agrupación
agu	aguas	agua,aguas
ahor	ahora	ahora
ahorr	ahorrar	ahorrar
air	aires	aire,aires
aisl	aisladas	aisladas
ajust	ajustado	ajustado,ajustan
alcald	alcaldes	alcaldes
alcanc	alcancen	alcance,alcancen
alcanz	alcanzados	alcanzados,alcanzar,alcanzaría
algu	alguien	alguien
algun	alguna	alguna,algún
aliment	alimentación	alimentación,alimentaria
alin	alineadas	alineadas
alla	allá	allá
almir	almirantes	almirantes
alta	alta	alta
altern	alternativos	alternativos
alto	alto	alto
altos	altos	altos
alumn	alumnos	alumnos
ambas	ambas	ambas
ambient	ambientales	ambiental,ambientales,ambiente
ambiguedad	ambigüedades	ambigüedades
ambit	ámbitos	ámbito,ámbitos
ambos	ambos	ambos
amdh	amdh	amdh
amenaz	amenazar	amenazar
amer	américa	américa
amigosconoc	amigosconocido	amigosconocido
amist	amistad	amistad
ampl	ampliar	amplia,ampliar,amplio
analisis	análisis	análisis
analit	analítico	analítico
analiz	analizado	analizado,analizar
anej	añejos	añejos
anex	anexo	anexo
angul	angular	angular
animal	animales	animales
anos	años	años
antagon	antagónico	antagónico
antart	antártica	antártica
antepon	anteponiendo	anteponiendo
anterior	anterior	anterior,anteriormente
aparec	aparece	aparece
aparient	apariencia	apariencia
apart	aparte	aparte
apl	apl	apl
aplic	aplicación	aplica,aplicación,aplicada,aplicar,aplicarlo,aplicarse
apliqu	aplique	aplique
aport	aportes	aporta,aportar,aportes
apost	apostamos	apostamos
apoy	apoyo	apoya,apoyo
aprend	aprender	aprender
aprendizaj	aprendizaje	aprendizaje
aprob	aprobación	aprobación,aprobadas
aprop	apropiado	apropiado
aprovech	aprovechamiento	aprovechamiento,aprovechando,aprovechar
aprueb	apruebe	apruebe
apunt	apunta	apunta
aqu	aquí	aquí
aquel	aquel	aquel
aquell	aquellas	aquella,aquellas,aquello
arbitr	arbitrarias	arbitraria,arbitrarias
arbitrariedad	arbitrariedades	arbitrariedades
arboretum	arboretum	arboretum
arcas	arcas	arcas
are	áreas	área,áreas
argentin	argentina	argentina
argument	argumentación	argumentaciones,argumentación,argumentos
armad	armadas	armadas
armon	armonía	armoniosa,armonioso,armonía,armónica,armónicamente,armónicas,armónico
arraig	arraigo	arraigo
arrebat	arrebatados	arrebatados
articul	articulación	articulación,artículo,artículos
artist	artísticas	artísticas
asambl	asambleas	asambleas
asamble	asamblea	asamblea
asegur	asegurarse	asegura,asegurada,asegurado,aseguran,asegurando,asegurar,asegurarse,asegure
asesor	asesoramiento	asesorados,asesoramiento
asi	asia	asia,así
asign	asignaciones	asignaciones
asim	asimismo	asimismo
asist	asistir	asistir
asistent	asistentes	asistencia,asistentes
asoc	asociación	asociación,asociada,asociado,asociados,asociarse
aspect	aspectos	aspecto,aspectos
aspir	aspiramos	aspiramos
asum	asumir	asume,asumir
asunt	asuntos	asunto,asuntos
atencion	atención	atención
atend	atender	atender
atent	atente	atente
atract	atractivo	atractivo
atras	atrás	atrás
atribu	atribuciones	atribuciones
atropell	atropellos	atropellos
august	augusto	augusto
aument	aumenten	aumentar,aumenten
aun	aún	aun,aún
aunqu	aunque	aunque
autent	auténtico	auténtico
autoconvoc	autoconvocado	autoconvocado
autodetermin	autodeterminación	autodeterminación
autoeduc	autoeducarnos	autoeducarnos
autoexpl	autoexplica	autoexplica
autogobiern	autogobierno	autogobierno
autonom	autonomías	autonomía,autonomías,autónoma,autónomo
autor	autoridades	autoridad,autoridades
autoriz	autorizar	autorizar
autorre	autorrealización	autorrealización
autorregul	autorregularse	autorregularse
avalu	avaluará	avaluará
avanc	avance	avance
avanz	avanzamos	avanzamos,avanzar
ayud	ayuda	ayuda
baj	bajarlo	bajarlo,bajo,bajos
barniz	barniz	barniz
barr	barrio	barrio
barrer	barreras	barrera,barreras
bas	basarse	basa,basada,basado,basarse,base,bases
basic	básicas	básicas,básico,básicos
bast	bastan	basta,bastan
bastant	bastantes	bastantes
bellez	belleza	belleza
benefic	beneficiados	beneficia,beneficiados,beneficie,beneficien,beneficio,beneficios
bicamer	bicameral	bicameral
bien	bienes	bien,bienes
bienest	bienestar	bienestar
bilater	bilaterales	bilaterales
binomin	binominal	binominal
biodivers	biodiversidad	biodiversidad
biolog	biológicas	biológicas
biopsicosoc	biopsicosocial	biopsicosocial
blic	blico	blico
bolivian	boliviana	boliviana
brind	brindar	brinda,brindar,brinde
buen	buenos	buen,buena,buenos
burocrac	burocracia	burocracia
busc	buscamos	busca,buscamos,buscando,buscar
busqu	búsqueda	búsqueda
cab	cabo	cabo
cad	cada	cada
caduc	caduco	caduco
calent	calentamiento	calentamiento
calid	calidad	calidad
call	calles	calle,calles
cam	cámaras	cámara,cámaras
camb	cambiarlo	cambiada,cambiar,cambiarlo,cambio,cambios
camin	camino	camino
camp	campo	campo
canch	cancha	cancha
cancill	canciller	canciller
cans	cansada	cansada
capac	capacidades	capaces,capacidad,capacidades
capaz	capaz	capaz
capital	capital	capital
carabiner	carabineros	carabineros
caract	carácter	carácter
caracterist	características	característica,características
carcel	cárcel	cárcel
carec	carece	carece
carenc	carencias	carencias
carent	carentes	carentes
carezc	carezca	carezca
carg	cargos	cargas,cargo,cargos
carib	caribe	caribe
carr	carro	carro
carrer	carreras	carreras
cart	carta	carta
cas	casos	casa,caso,casos
catastrof	catástrofes	catástrofe,catástrofes
caus	causado	causado
causal	causales	causales
cautel	cautelan	cautelan,cautelando
ced	ceder	ceder
censur	censura	censura
centen	centenario	centenario
centr	centros	centro,centros
central	centralista	central,centrales,centralista,centralizar
cer	cero	cero
cercan	cercana	cercana
chil	chile	chile
chilen	chilenas	chilena,chilenas,chileno,chilenos
cientif	científicas	científicas
ciert	ciertos	cierto,ciertos
ciment	cimentado	cimentado
cin	ciñe	ciñe
circul	circulación	circulación
circunscripcion	circunscripción	circunscripción
circunst	circunstancias	circunstancias
cit	cita	cita
ciud	ciudad	ciud,ciudad
ciudad	ciudades	ciudades
ciudadan	ciudadanía	ciudadana,ciudadanas,ciudadano,ciudadanos,ciudadanía
civic	cívico	cívica,cívicamente,cívico
civil	civiles	civil,civiles
civiliz	civilizaciones	civilizaciones,civilizadamente
clar	claro	clara,claro
clas	clases	clase,clases
clav	clave	clave
clim	clima	clima
club	clubes	clubes
coart	coarten	coartar,coarte,coarten
cobertur	cobertura	cobertura
cobr	cobre	cobre
coex	coexiste	coexiste
coexist	coexistan	coexistan
coherent	coherentes	coherencia,coherente,coherentes
coincid	coincidimos	coincidimos
coj	coja	coja
colabor	colaboración	colaboración,colaborativa,colaborativo
colect	colectivas	colectica,colectiva,colectivamente,colectivas,colectivo,colectivos
coleg	colegio	colegio
coloc	colocando	colocando
color	color	color
combat	combatir	combatir
coment	comentarios	comentario,comentarios
comerc	comerciales	comercial,comerciales
comienz	comienzan	comienza,comienzan,comienzo
comod	cómoda	cómoda
compart	compartimos	comparte,comparten,compartimos,compartir
compel	compele	compele
compet	competen	competen,competir
competent	competencias	competencias
complement	complementarias	complementarias,complementaría
complet	completado	completado,completamente,completo
compon	componen	componen
comport	comportarse	comportarse
comprend	comprender	comprenda,comprender,comprendiendo
compromet	comprometerse	compromete,comprometerse,comprometida
compromis	compromisos	compromisos
compuest	compuesta	compuesta
comput	computación	computación
comun	comunidades	comuna,comunas,comunes,comunidad,comunidades,común
comunal	comunales	comunal,comunales
comuncomun	comúncomunidad	comúncomunidad
comunic	comunicación	comunicación
comunit	comunitarias	comunitaria,comunitarias,comunitario
concentr	concentración	concentración,concentrado
concept	conceptos	concepto,conceptos
concernient	concerniente	concerniente
concib	concibe	concibe,concibiendo
concienc	conciencia	conciencia
conclusion	conclusión	conclusión
concord	concordancia	concordados,concordancia
conden	condenar	condena,condenar
condicion	condición	condicionada,condiciones,condición
conduc	conduce	conduce
conduct	conducta	conducta
conect	conectividad	conectividad
confesion	confesionales	confesional,confesionales,confesiones
confianz	confianza	confianza
configur	configuración	configuración
conflict	conflictos	conflicto,conflictos
conform	conforma	conforma,conforme
confund	confundirse	confundirse,confundió
congreg	congregaron	congregaron
congres	congreso	congreso
conjug	conjuga	conjuga
conjunt	conjunto	conjunto
conoc	conocimientos	conocemos,conocida,conocidas,conocimientos
conozc	conozcan	conozcan
cons	consiste	consiste
consagr	consagrado	consagrado,consagrar
conscienc	consciencia	consciencia
conscient	conscientes	consciente,conscientes
consecucion	consecución	consecución
consecuent	consecuencias	consecuencia,consecuencias
consegu	conseguir	conseguir
consej	consejos	consejo,consejos
consejer	consejeros	consejeros
consens	consenso	consenso
conserv	conservación	conservación,conservar,conservarla
consider	consideración	considera,consideración,considerada,consideradas,considerado,considerados,consideramos,consideran,considerando,considerar,considerarlo,consideraron,considerarse,considere,consideren,consideró
consient	consientes	consiente,consientes
consign	consignados	consignados
consolid	consolidación	consolidación
const	consta	consta
constanc	constancia	constancia
constant	constante	constante,constantemente
constitu	constituciones	constituciones,constituir,constituya,constituye
constitucion	constitución	constitucional,constitucionales,constitucionalmente,constitucionario,constitución
constituyent	constituyentes	constituyente,constituyentes
constru	construiremos	construida,construido,construir,construiremos,construye
construccion	construcción	construcción
consult	consultivos	consulta,consultas,consultiva,consultivos
consum	consumo	consumo
consumidor	consumidor	consumidor
cont	contar	contar
contamin	contaminación	contaminación
contempl	contemplamos	contempla,contemplada,contemplados,contemplamos,contemplar,contemplarse,contemple
conten	contenidos	contenido,contenidos
contenc	contencioso	contencioso
contencion	contención	contención
content	contentos	contentos
context	contexto	contexto
contien	contiene	contiene
continent	continentes	continentes
contingent	contingente	contingente
continu	continuidad	continuamente,continuidad,continuo,continúe
contr	contrario	contrario
contralor	contraloría	contraloría
contrapes	contrapeso	contrapeso
contrat	contratos	contratar,contratos
contribu	contribuyan	contribuir,contribuyan,contribuye
control	controlador	control,controlador,controlar
conven	convenios	convenios
convers	conversar	conversar
convert	convertir	convertir
conviccion	convicción	convicción
conviv	convivir	convivir
convivent	convivencia	convivencia
convoc	convocado	convocado,convocar
convocator	convocatoria	convocatoria
cooper	cooperación	cooperación
cop	copia	copa,copia,copie
corpor	corporaciones	corporaciones,corporalidad
correct	correcta	correcta,correctamente
correspond	correspondan	corresponda,correspondan
correspondient	correspondiente	correspondiente
corrupcion	corrupción	corrupción
cortoplac	cortoplacistas	cortoplacistas
cos	cosas	cosas
cost	costos	costos
cre	creación	creación,creando,crear,crearla,cree,creemos,creen,creo
creativ	creativas	creativas
crec	crecer	crecer
cred	credo	credo
creenc	creencias	creencia,creencias
criter	criterios	criterio,criterios
critic	críticas	crítica,críticas,crítico
crucial	crucial	crucial
cual	cuales	cuales,cuáles
cualesqu	cualesquiera	cualesquiera
cualqu	cualquier	cualquier
cuant	cuánto	cuanto,cuánto
cuart	cuarto	cuarta,cuarto
cuatr	cuatro	cuatro
cuent	cuenten	cuenta,cuente,cuenten
cuerp	cuerpo	cuerpo
cuestion	cuestiones	cuestionar,cuestiones,cuestión
cuid	cuidados	cuidad,cuidado,cuidados,cuidamos,cuidar
culpabil	culpabilidad	culpabilidad
cult	culto	culto
cultur	culturales	cultura,cultural,culturales,culturalmente,culturas
cumpl	cumplirla	cumplan,cumple,cumplen,cumplida,cumpliendo,cumplir,cumplirla,cumplirse
cumplimeitn	cumplimeitno	cumplimeitno
cumplimient	cumplimientos	cumplimiento,cumplimientos
cun	cuna	cuna
cuot	cuota	cuota
cuote	cuoteos	cuoteos
curricul	curricular	curricular
cuy	cuya	cuya
dad	dado	dad,dado
dan	dañan	dan,dañan,dañar,daño
dand	dando	dando
dar	daría	dar,daría
darl	darle	darle
dat	datos	datos
ddhh	ddhh	ddhh
deb	debiesen	deba,debe,debemos,deber,debida,debido,debiera,debieran,debiese,debiesen
debat	debatir	debate,debatir
deber	deberíamos	deberes,debería,deberíamos,deberían
deberrespons	deberresponsabilidad	deberresponsabilidad
debid	debidamente	debidamente
debies	debiésemos	debiésemos
dec	décadas	decida,decir,décadas
decepcion	decepción	decepción
decid	decididas	decide,decididas,decidido,decidir
decision	decisiones	decisiones,decisión
declar	declaración	declaraciones,declaración,declarando,declare
defend	defenderla	defender,defenderla
defens	defensas	defensa,defensas
defensor	defensores	defensor,defensores,defensoría
deficient	deficiencias	deficiencias
deficit	déficit	déficit
defin	definirse	defina,definan,define,definen,definido,definir,definirse
definicion	definición	definiciones,definición
dej	dejamos	dejamos,dejar
deleg	delegación	delegación,delegados,delegan
deliber	deliberación	deliberación
delictu	delictual	delictual
delincuent	delincuentes	delincuentes
delit	delito	delito
dem	demás	demás
demand	demanda	demanda
democ	democratización	democracia,democratización,democrática,democráticamente,democráticas,democrático,democráticos
demograf	demográfica	demográfica
demostr	demostrar	demostrar
denomin	denominar	denomina,denominar
densid	densidad	densidad
dentr	dentro	dentro
departament	departamental	departamental
depend	depender	depender,dependiendo
dependent	dependencia	dependencia
dependient	dependientes	dependientes
deport	deportivos	deporte,deportivas,deportivos
deposit	depositaria	depositaria
derech	derechos	derecha,derechos
deriv	derivados	derivados
derog	derogue	derogue
dersertific	dersertificación	dersertificación
des	deseamos	deseamos
desarroll	desarrollándose	desarrolla,desarrollado,desarrollar,desarrollarse,desarrolle,desarrollo,desarrollándose
descalifiqu	descalifique	descalifique
descart	descarte	descarte
descentr	descentralización	descentraliza,descentralización,descentralizar
desconcentr	desconcentración	desconcentración,desconcentrar
desconf	desconfianza	desconfianza
desconoc	desconocerlos	desconocerlos
descont	descontando	descontando
descredit	descredito	descredito
descrit	descrita	descrita
desech	desechable	desecha,desechable
desempen	desempeñan	desempeñan
desemple	desempleo	desempleo
desequilibr	desequilibrio	desequilibrio
desesperanz	desesperanzados	desesperanzados
desestabil	desestabilización	desestabilización
design	designarle	designada,designarle,designará
desiguald	desigualdad	desigualdad
desigualdad	desigualdades	desigualdades
desinter	desinterés	desinterés
desinteres	desinteresada	desinteresada
desmedr	desmedro	desmedro
desmercantil	desmercantilizar	desmercantilizar
despleg	desplegado	desplegado
despu	después	después
destac	destacamos	destacamos,destacó
destin	destinadas	destinadas,destinado,destinos
destitucion	destitución	destitución
destru	destruyendo	destruyendo
destruccion	destrucción	destrucción
detall	detallar	detallar
determin	determinantes	determina,determinada,determinados,determinantes,determinar,determinen
devuelv	devuelve	devuelve
dia	día	día
dialog	dialogo	dialogo,diálogo
diar	diaria	diaria
dic	dice	dice
dich	dichas	dichas,dicho,dichos
dict	dictado	dictado,dictar
dictadur	dictadura	dictadura
dictator	dictatorial	dictatorial
diet	dietas	dietas
difam	difamación	difamación
diferent	diferencias	diferencias,diferente,diferentes
dificil	difícil	difícil
dificultad	dificultades	dificultades
difund	difundir	difunda,difundir
difusion	difusión	difusión
dign	dignas	digna,dignas,digno
dignid	dignidad	dignidad
dimension	dimensión	dimensión
dinam	dinámicas	dinámica,dinámicas
diner	dinero	dinero
dio	dio	dio
diput	diputados	diputados
direct	directas	directa,directamente,directas,directo
dirigent	dirigentes	dirigentes
dirim	dirimir	dirimir
discapac	discapacidad	discapacidad
discapacit	discapacitados	discapacitados
disciplin	disciplinamiento	disciplinamiento
discrep	discrepamos	discrepamos
discrimin	discriminación	discrimina,discriminaciones,discriminación,discriminada,discriminadoras,discriminados,discriminar,discrimine
discriminator	discriminatorias	discriminatorias,discriminatorio
discusion	discusiones	discusiones,discusión
discut	discutirse	discutido,discutir,discutirse,discutió
disen	diseñar	diseñar,diseño
disfrut	disfrutar	disfrutar
disminu	disminuir	disminuir
dispon	disponen	disponen,disponer
disponibil	disponibilidad	disponibilidad
disposicion	disposición	disposición
disrimin	disriminación	disriminación
distant	distante	distante
distincion	distinción	distinción
distint	distintos	distinta,distintas,distinto,distintos
distribu	distribuidos	distribuidos,distribuirse,distribuya,distribuyen
distribucion	distribución	distribución
distrit	distrital	distrital
divergent	divergencias	divergencia,divergencias
divers	diversidades	diversas,diversidad,diversidades,diverso,diversos
diversion	diversión	diversión
division	división	división
divulg	divulgación	divulgación
dobl	doble	doble
doctrin	doctrina	doctrina
document	documentos	documentos
dogmat	dogmatismo	dogmatismo
domin	dominantes	dominantes,dominio
dos	dos	dos
dot	dotados	dotados
dud	duda	duda
dudh	dudh	dudh
duen	dueños	dueños
dur	duración	dura,duración
durader	duradera	duradera
ecolog	ecológica	ecológica
econom	económicas	economía,economías,económica,económicas,económico,económicos
ecosistem	ecosistemas	ecosistema,ecosistemas
ecuatorian	ecuatoriana	ecuatoriana
edad	edad	edad
edific	edificio	edificio
educ	educación	educación,educar,educarse,educativas,educativo,educativos
educacion	educacionales	educacional,educacionales
efect	efectivos	efectiva,efectivo,efectivos,efecto,efectos
efectu	efectúa	efectúa
efimer	efímeros	efímero,efímeros
egoist	egoísta	egoísta
eje	eje	eje
ejecut	ejecutivo	ejecutar,ejecuten,ejecutiva,ejecutivo
ejempl	ejemplos	ejemplo,ejemplos
ejerc	ejercerlos	ejerce,ejercen,ejercer,ejercerlos
ejercic	ejercicio	ejercicio
ejerz	ejerza	ejerza
ejes	ejes	ejes
ela	ela	ela
elabor	elaboración	elaboración,elaborada,elaborar
eleccion	elección	elecciones,elección
elect	electos	electa,electas,electo,electos
elector	electorales	electoral,electorales
electors	electors	electors
eleg	elegidas	elegida,elegidas,elegido,elegidos,elegir
elegir	elegiría	elegiría
element	elementos	elemental,elemento,elementos
elig	eligieron	elige,eligieron
elim	elimar	elimar
elimin	eliminación	eliminación,eliminar
elit	élite	élite
ello	ello	ello
elusion	elusión	elusión
embarg	embargo	embargo
emerg	emergida	emergida
emergent	emergentes	emergencia,emergentes
emocion	emocional	emocional
empat	empáticos	empatía,empáticos
empatiz	empatizar	empatizar
empez	empezar	empezar
empiez	empieza	empieza
emple	emplear	emplear,empleo
empres	empresas	empresa,empresas
encamin	encaminados	encaminados
encar	encarar	encarar
encarg	encargados	encargado,encargados
encomend	encomendada	encomendada
encontr	encontrarse	encontrar,encontrarse
encuentr	encuentren	encuentra,encuentran,encuentren
ende	ende	ende
enend	enendemos	enendemos
energ	energía	energía
energet	energéticas	energéticas,energéticos
enfasis	énfasis	énfasis
enfatiz	enfatizó	enfatizando,enfatizó
enferm	enfermedad	enfermedad,enfermos
enfoc	enfocarse	enfocar,enfocarse
enfoqu	enfoque	enfoque
enfrent	enfrentarse	enfrentarse
englob	engloba	engloba
enmarc	enmarca	enmarca
enriquec	enriquecimiento	enriquecimiento
enriquecedor	enriquecedora	enriquecedora
ensen	enseñanza	enseñanza,enseñarse
ente	ente	ente
entend	entendernos	entendamos,entendemos,entender,entenderlo,entendernos,entendida,entendido,entendiendo
entes	entes	entes
entid	entidad	entidad
entidad	entidades	entidades
entiend	entiende	entiende
entonc	entonces	entonces
entorn	entorno	entorno
entreg	entregados	entrega,entregados,entregar,entregarán,entregue
envuelt	envueltos	envueltos
equid	equidad	equidad
equilibr	equilibrado	equilibrada,equilibrado,equilibrio,equilibrios
equip	equipos	equipos
equit	equitativo	equitativa,equitativo
error	errores	errores
escal	escalas	escala,escalas
escas	escaso	escasa,escaso
escen	escenario	escenario
esceptic	escepticismo	escepticismo
escog	escoger	escoger
escrit	escrito	escrito
escrutin	escrutinio	escrutinio
escuch	escuchadas	escuchada,escuchadas,escuchado,escuchar
esenc	esenciales	esencia,esencial,esenciales
esfer	esferas	esferas
esfuerz	esfuerzo	esfuerzo
espac	espacios	espacios
espec	especiales	especial,especiales,especialmente,especie,especies
especif	específicas	específica,específicamente,específicas
especifiqu	especifique	especifique
esper	esperamos	esperamos,esperanza
esperanz	esperanzados	esperanzados
espiritu	espiritual	espiritual,espíritu
estabil	estabilidad	estabilidad
establ	estable	estable
establec	establecimiento	establece,establecer,establecerse,estableciendo,establecimiento
establezc	establezca	establezca
estan	están	están
estandar	estándares	estándares
estar	estarán	estará,estarán
estatal	estatales	estatal,estatales
estatus	estatus	estatus
esten	estén	estén
estil	estilo	estilo
estim	estime	estime
estipul	estipulado	estipulado
estrat	estratos	estratos
estrateg	estratégicos	estratégico,estratégicos
estructur	estructuras	estructura,estructuras
estud	estudios	estudios
etap	etapas	etapa,etapas
etare	etáreos	etáreos
etc	etc	etc
etceter	etcétera	etcétera
etic	éticas	ética,éticas
etn	etnia	etnia
etnic	étnicas	étnica,étnicas,étnicos
europ	europa	europa
eutanas	eutanasia	eutanasia
evasion	evasión	evasión
eventu	eventuales	eventuales
evidenc	evidenciamos	evidenciamos
evit	evitar	evitando,evitar
evolucion	evolución	evolución
examin	examinar	examinar
excepcion	excepción	excepción
exces	excesivos	excesivos
exclu	excluyen	excluye,excluyen
exclusion	exclusión	exclusión
exig	exigen	exige,exigen,exigiendo,exigir
exij	exijan	exijan
exist	existen	exista,existan,existe,existen,existiendo,existir
existent	existentes	existencia,existente,existentes
existir	existirán	existirán
exit	éxitos	éxitos
expect	expectativas	expectativas
expedit	expeditos	expeditos
experient	experiencias	experiencia,experiencias
expert	expertos	expertos
explic	explica	explica,explicó
explot	explotación	explotación,explotados
expon	exponer	exponer
expres	expresada	expresa,expresada,expresar,exprese
expresion	expresiones	expresiones,expresión
expuest	expuestos	expuesto,expuestos
exterior	exterior	exterior
extern	externalidades	externalidades,externalizar
extiend	extiendan	extiendan
extraccion	extracción	extracción
extranjer	extranjeras	extranjeras,extranjero
facil	fácil	fácil
facilit	facilitación	facilita,facilitación,facilitadora,facilitando,facilitar,facilitarse,facilite
factibil	factibilidad	factibilidad
factic	fácticos	fácticos
facult	facultad	facultad
facultad	facultades	facultades
fall	fallas	fallan,fallas
fals	falsas	falsas
falt	falta	falta
famil	familias	familia,familiar,familias
faun	fauna	fauna
favor	favor	favor
favorec	favorecer	favorece,favorecer
federal	federalismo	federal,federalismo
federalismoautonom	federalismoautonomía	federalismoautonomía
femenin	femenino	femenino
ffa	ffaa	ffaa
fiel	fiel	fiel
figur	figuras	figura,figuras
fij	fijarse	fijando,fijarse
fin	fines	fin,fines
final	finalización	final,finalidad,finalización,finalmente
financ	financiamiento	financiamiento,financiar
financier	financieros	financieros
fiscal	fiscalización	fiscal,fiscales,fiscaliza,fiscalización,fiscalizador,fiscalizar
fisic	físico	física,físicamente,físico
fisicapsicolog	físicapsicológica	físicapsicológica
flor	flora	flora
foment	fomentar	fomentando,fomentar,fomento
fonas	fonasa	fonasa
fond	fondo	fondo
form	formación	forma,formación,forman,formando,formar,formas
formal	formal	formal,formalmente
formul	formulación	formulación
fortalec	fortalecimiento	fortalecer,fortaleciendo,fortalecimiento
forz	forzar	forzar
fot	foto	foto
fratern	fraternidad	fraternalmente,fraternidad
frent	frente	frente
fuent	fuentes	fuentes
fuer	fueros	fueren,fueros
fuert	fuertes	fuerte,fuertes
fuerz	fuerzas	fuerza,fuerzas
funcion	función	funciona,funcional,funcionales,funcionamiento,funcionarios,funcionen,funciones,función
fund	fundar	funda,fundar
fundament	fundamentalismos	fundamental,fundamentales,fundamentalismos,fundamentos
fusion	fusionamos	fusionamos
futur	futuros	futuras,futuro,futuros
gabinet	gabinete	gabinete
galean	galeano	galeano
gan	ganar	ganar,gane
gananc	ganancias	ganancias
garant	garantizándola	garante,garantiza,garantizada,garantizado,garantizados,garantizan,garantizando,garantizar,garantizándola,garantizándole,garantía,garantías
garantic	garantice	garantice
gast	gastos	gasto,gastos
gendarmer	gendarmería	gendarmería
gener	generaciones	genera,generaciones,generada,generado,generamos,generando,generar,genere,generen,genero,género,géneros
generacion	generacional	generacional
general	generalizada	general,generales,generalizada,generalmente
generalisim	generalísimo	generalísimo
gent	gente	gente
geograf	geográficas	geografía,geográfica,geográficas,geográfico
ges	ges	ges
gestion	gestión	gestión
global	global	global
glos	glosario	glosario
gob	gobiernos	gobierno,gobiernos
gobern	gobernantes	gobernando,gobernantes,gobernar
goc	goce	goce
goz	gozar	gozar
grad	grado	grado
grafic	graficar	graficar
gran	gran	gran
grand	grandes	grandes
gratuid	gratuidad	gratuidad
gratuit	gratuitas	gratuita,gratuitas,gratuito
grav	graves	graves
grup	grupos	grupo,grupos
guerr	guerra	guerra
gui	guía	guía,guíe
gust	gustaría	gustaría
hab	había	haber,había
habit	habitantes	habitantes
habitats	hábitats	hábitats
habl	hablar	hablar
habr	habría	habrá,habría
hac	hacerlo	hace,hacen,hacer,hacerlo,hacerse,hacia,haciendo,hacía
hacin	hacinamiento	hacinamiento
hag	hagamos	haga,hagamos,hagan
har	haría	haría
hech	hecho	hecho
herenc	herencia	herencia
herramient	herramientas	herramienta,herramientas
hic	hicieron	hice,hicieron
hidric	hídrico	hídrico
hij	hijos	hijos
histor	históricas	historia,historica,histórica,históricas,histórico
hog	hogar	hogar
hombr	hombres	hombre,hombres
homogene	homogéneo	homogéneo
honr	honrados	honrados
hor	horas	hora,horas
horizont	horizontal	horizontal,horizonte
hospit	hospital	hospital
hoy	hoy	hoy
hrs	hrs	hrs
huelg	huelga	huelga
human	humanidad	humana,humanas,humanidad,humano,humanos
ide	ideario	idea,ideario,ideas
ident	identidades	identidad,identidades,idéntico,idénticos
ideolog	ideológicos	ideológicos
idiom	idioma	idioma
igles	iglesias	iglesia,iglesias
igual	iguales	igual,igualar,iguales,igualmente
iguald	igualdad	igualdad
igualit	igualitario	igualitaria,igualitario
iii	iii	iii
ileg	ilegibles	ilegible,ilegibles
ilegal	ilegal	ilegal
ilegitim	ilegítimo	ilegitima,ilegítimo
ilimit	ilimitado	ilimitado
imp	impedir	impedir
impact	impacto	impacto
impid	impida	impida
implement	implementarse	implementarse
implic	implican	implica,implican
implicit	implícito	implícito
impon	imponer	imponer
import	importancia	importa,importancia,importando,importante,importar
impos	imposibles	imposibles
imposicion	imposición	imposición
imprescind	imprescindible	imprescindible
impuest	impuestos	impuestos
impuls	impulsar	impulsando,impulsar
impulsor	impulsor	impulsor
inadmis	inadmisible	inadmisible
inalien	inalienables	inalienable,inalienables
incentiv	incentivar	incentivar
inciat	inciativa	inciativa
incident	incidencia	incidencia
incidir	incidirán	incidirán
inclu	incluidas	incluidas,incluido,incluidos,incluimos,incluir,incluirse,incluya,incluye,incluyen,incluyendo
inclus	inclusivo	inclusivo,incluso
inclusion	inclusión	inclusión
incorpor	incorporación	incorporación,incorporada,incorporado,incorporando,incorporar,incorpore
increment	incrementa	incrementa
incumbent	incumbentes	incumbentes
indefin	indefinida	indefinida
independent	independencia	independencia
independient	independientes	independiente,independientes
indigen	indígenas	indígenas
indigent	indigentes	indigentes
indirect	indirectamente	indirectamente
individu	individualistas	individual,individuales,individualismo,individualista,individualistas,individuo,individuos
indol	índole	índole
induccion	inducción	inducción
industr	industrial	industria,industrial
inelud	ineludible	ineludible
inequ	inequidad	inequidad
infanc	infancia	infancia
inferior	inferioridad	inferioridad
influ	influyendo	influyendo
influenc	influencias	influencias
inform	información	informaciones,información,informadas,informarse
infraccion	infracción	infracciones,infracción
infraestructur	infraestructura	infraestructura
infring	infringe	infringe
ingres	ingresar	ingresar,ingreso
inhabilit	inhabilitación	inhabilitación
inherent	inherentes	inherente,inherentes
inic	iniciativas	inician,iniciativa,iniciativas,inicio,inicios
injustic	injusticia	injusticia
inmigr	inmigrantes	inmigrantes
inneces	innecesario	innecesario
innov	innovación	innovación
inocent	inocencia	inocencia,inocente
insert	insertos	inserto,insertos
instal	instale	instale
instanc	instancias	instancia,instancias
instaur	instaure	instaure
institu	instituciones	instituciones,instituido
institucion	institución	institucional,institucionalidad,institución
institut	instituto	instituto
instru	instruya	instruya
instruccion	instrucción	instrucciones,instrucción
instrument	instrumentos	instrumento,instrumentos
instrumentalic	instrumentalice	instrumentalice
insuficient	insuficiente	insuficiente
insum	insumos	insumos
intang	intangible	intangible
integr	integración	integra,integración,integrada,integral,integralmente,integran,integrante,integrantes,integrarnos,integridad
intelectu	intelectualmente	intelectualmente
intendent	intendente	intendente
intent	intentos	intenta,intentos
inter	interés	interés
interaccion	interacción	interacción
intercultur	interculturalidad	interculturalidad
interdependent	interdependencia	interdependencia
interes	intereses	interesan,intereses
interf	interfiera	interfiera
interlocutor	interlocutores	interlocutores
intermed	intermedio	intermedio
intern	internalizar	internalizar
internacion	internacionales	internacional,internacionales
internet	internet	internet
interpret	interpretamos	interpretamos
interrel	interrelación	interrelación
interrupcion	interrupción	interrupción
interven	intervenimos	intervenimos
intervencion	intervención	intervención
intrafamil	intrafamiliar	intrafamiliar
invalid	invalidar	invalidar
invalidez	invalidez	invalidez
inversion	inversión	inversión
investig	investigación	investigación
invisibil	invisibilizarlos	invisibilizarlos
invit	invitación	invitación,invitados
involucr	involucrarnos	involucra,involucrarnos
irrenunc	irrenunciables	irrenunciables
irrestrict	irrestrictos	irrestrictos
isapr	isapres	isapres
isla	isla	isla
jav	javiera	javier,javiera
jef	jefes	jefe,jefes
jefatur	jefatura	jefatura
jerarqu	jerarquizada	jerarquizada,jerarquizar,jerarquía,jerárquicamente
joven	jóvenes	jóvenes
jubil	jubilación	jubilación
judic	judicial	judicial
jug	jugar	jugar
juic	juicios	juicio,juicios
jun	junio	junio
junt	juntarse	junta,juntarse,juntas,junto
jurid	jurídicas	jurídica,jurídicas,jurídico
just	justo	justa,justamente,justo
justic	justicia	justicia
justific	justificar	justificar
juventud	juventud	juventud
juzg	juzgado	juzgado
kilometr	kilómetro	kilómetro
labor	labores	labores
laboral	laborales	laboral,laborales
lad	lado	lado
laic	laico	laica,laico
larg	largo	largo
laz	lazos	lazo,lazos
leg	legado	legado
legal	legales	legal,legales,legalmente
legisl	legislación	legislación,legislativa,legislativamente,legislativo,legislativos,legisle
legit	legítimos	legítimos
legitim	legitimidad	legitimado,legitimar,legitimidad,legítima,legítimamente,legítimas,legítimo
lej	lejos	lejos
lengu	lenguas	lenguas
lenguaj	lenguaje	lenguaje
ley	leyes	ley,leyes
libert	libertad	libertad
libertad	libertades	libertades
libr	libres	libre,libres
librement	libremente	libremente
limit	limitados	limitados,límite,límites
limp	limpias	limpias
line	línea	línea
linguist	lingüísticas	lingüísticas
list	lista	lista
lit	litio	litio
llam	llamado	llamado,llamar
lleg	llegue	llega,llegar,llegue,llegó
llev	llevado	lleva,llevado,llevar
local	localidades	localidades
localmunicip	localmunicipal	localmunicipal
locomocion	locomoción	locomoción
logr	lograría	logran,logrando,lograr,lograría,logro,logros
luch	luchar	luchar
lucr	lucro	lucro
lueg	luego	luego
lug	lugar	lugar
machist	machista	machista
macr	macro	macro
magistr	magistrados	magistrado,magistrados
magn	magna	magna
maipu	maipú	maipú
maltrat	maltratados	maltratados
man	manos	mano,manos
mandat	mandato	mandato
mandator	mandatorio	mandatorio
maner	manera	manera
manifest	manifestarse	manifestar,manifestarse,manifestará
manifiest	manifieste	manifieste
manten	mantenimiento	mantener,mantenerla,mantenerse,manteniendo,mantenimiento
mantencion	mantención	mantención
mantendr	mantendrá	mantendrá
manteng	mantengan	mantenga,mantengan
mantien	mantiene	mantiene
marc	marco	marco
mas	más	más
masific	masificar	masificar
mater	materializar	materia,material,materiales,materializa,materializar,materias
maul	maule	maule
maxim	máximas	máxima,máximas,máximo
may	mayo	mayo
mayor	mayorías	mayor,mayores,mayoría,mayorías
mayorit	mayoritarios	mayoritariamente,mayoritarios
mdm	mdm	mdm
mecan	mecanismos	mecanismo,mecanismos
med	medidas	media,medida,medidas,medio,medios
median	mediano	mediano
mediant	mediante	mediante
medic	médicas	médica,médicas
medioambient	medioambientales	medioambientales,medioambiente
mediocr	mediocre	mediocre
mejor	mejores	mejor,mejora,mejorar,mejores
memor	memoria	memoria
men	menos	menos
mencion	mencionados	mencionado,mencionados
menor	menor	menor
menoscab	menoscabar	menoscabar,menoscabe
menosprec	menosprecio	menosprecio
ment	mentes	mentes
mental	mental	mental
mer	mero	meramente,mero
merc	mercado	mercado
mercadotecn	mercadotécnicas	mercadotécnicas
mercanc	mercancía	mercancía
mercantil	mercantilizado	mercantilizado
merec	merecemos	merecemos
merit	méritos	méritos
merm	mermada	mermada
mes	mesa	mesa
metodolog	metodologías	metodología,metodologías
mezcl	mezclar	mezclar
miembr	miembros	miembro,miembros
mientr	mientras	mientras
miercol	miércoles	miércoles
migr	migraciones	migraciones
milit	militar	militar
min	mínimos	mínimos
mineduc	mineduc	mineduc
mineral	minerales	mineral,minerales
minim	mínimas	mínima,mínimas,mínimo
minister	ministerios	ministerio,ministerios
ministr	ministros	ministro,ministros
minor	minorías	minorías
minorit	minoritarios	minoritarias,minoritarios
mir	mirada	mirada,mirar
mision	misión	misión
mism	mismos	misma,mismas,mismo,mismos
mod	modo	modo
model	modelo	modelo
modern	modernas	modernas,moderno
modest	modestos	modestos
modific	modificación	modificación,modificarla
modifiqu	modifique	modifique
modul	módulos	módulo,módulos
moment	momento	momento
monet	monetarios	monetarios
monopol	monopolización	monopolios,monopolización
mor	morir	morir
moral	moralidades	moral,morales,moralidades
motiv	motivación	motivación,motivar,motive,motivos
motor	motor	motor
mov	movida	movida
movil	movilización	movilidad,movilización
moviliz	movilizarse	movilizarse
movimient	movimiento	movimiento
msim	msimo	msimo
much	mucha	mucha
muerd	muerdo	muerdo
muert	muerte	muerte
mujer	mujeres	mujeres
multicultur	multiculturalismo	multicultural,multiculturalidad,multiculturalismo
multipliqu	multipliquen	multipliquen
mund	mundo	mundo
municip	municipales	municipal,municipales,municipio,municipios
mutu	mutua	mutua
nac	nacemos	nacemos,nacen,nacer,nacida,naciste
nacimient	nacimiento	nacimiento
nacion	nación	nacional,nacionales,nacionalidad,naciones,nación
nad	nadie	nadie
natural	naturales	natural,naturales,naturalmente
naturalez	naturaleza	naturaleza
neces	necesidades	necesaria,necesariamente,necesarias,necesario,necesarios,necesidad,necesidades
necesit	necesitadas	necesita,necesitadas,necesitamos,necesite
neg	negará	negará
negat	negativas	negativas
negligent	negligencias	negligencias,negligente
negoc	negociación	negociaciones,negociación
neoliber	neoliberalismo	neoliberalismo
nepot	nepotismo	nepotismo
neutr	neutro	neutro
nin	niños	niñ,niña,niñas,niño,niños
ningun	ninguna	ninguna,ningún
ninonin	niñoniña	niñoniña
nivel	niveles	nivel,nivelar,niveles
nobil	nobiliarios	nobiliarios
nocion	noción	noción
nombr	nombrado	nombrado
norm	normas	norma,normar,normas
normal	normalidad	normales,normalidad
normat	normativa	normativa
nort	norte	norte
norteamer	norteamérica	norteamérica
not	nota	nota
nucle	núcleo	núcleo
nuev	nuevas	nueva,nuevas,nuevo
nul	nulo	nulo
numer	numerosas	numerosas
nunc	nunca	nunca
nuno	ñuñoa	ñuñoa
objet	objetivos	objetivo,objetivos,objeto
oblig	obligación	obligaciones,obligación,obligados
obligator	obligatorias	obligatoria,obligatorias,obligatorio
obras	obras	obras
observ	observancia	observancia
obstacul	obstáculos	obstáculos
obstant	obstante	obstante
obstruccion	obstrucción	obstrucción
obten	obtenidos	obtener,obtenidos
ocasion	ocasionar	ocasionar
ocean	oceanía	oceanía
ocup	ocupación	ocupa,ocupación,ocupan
odi	odiosidad	odiosidad
ofic	oficio	oficio
oficial	oficialistas	oficial,oficialistas
oit	oit	oit
olvid	olvidados	olvidado,olvidados
omision	omisiones	omisiones
opcion	opción	opciones,opción
opinion	opiniones	opiniones,opinión
opon	opone	opone
oportun	oportunidades	oportunidad,oportunidades,oportuno
oposicion	oposición	oposición
opositor	opositores	opositores
optar	optar	optar
optim	óptimo	óptimo
orden	ordenados	orden,ordena,ordenados,ordenar
ordin	ordinarios	ordinarios
orfand	orfandad	orfandad
organ	organización	organismo,organismos,organización,órgano,órganos
organiz	organizaciones	organizaciones,organizada,organizarnos,organizarse
orgull	orgullosos	orgullosos
orient	orientación	orientaciones,orientación,orientada,orientadas,orientar,orientarse,oriente,orientándose
orig	origen	origen
origin	originarios	original,originarios
otorg	otorgándole	otorga,otorgada,otorgando,otorgar,otorgándole
pacif	pacíficas	pacífica,pacíficas,pacíficos
pact	pactos	pacten,pacto,pactos
pag	pague	pagar,pago,pague
pais	país	país
paisaj	paisaje	paisaje
paisajist	paisajística	paisajística
palabr	palabras	palabra,palabras
paliat	paliativos	paliativos
parcial	parciales	parciales,parcialmente
pare	parea	parea
parec	parecen	parece,parecen,pareció
parent	parental	parental
parentesc	parentesco	parentesco
parezc	parezca	parezca
parlament	parlamentarios	parlamentaria,parlamentario,parlamentarios,parlamento,parlamentos
parrticip	parrticipativas	parrticipativas
part	partidos	parte,partidos,partir
particip	participación	participación,participado,participan,participar,participativa,participativo,participativos,participe,participen
particul	particular	particular
particular	particularidades	particulares,particularidad,particularidades,particularmente
pas	pasados	pasa,pasado,pasados,pasar,pase,pasen
pascu	pascua	pascua
patolog	patologías	patologías
patrimon	patrimonial	patrimonial,patrimonio
patrocin	patrocinio	patrocinio
paut	pautas	pautas
paz	paz	paz
peg	pegue	pegar,pegue
pel	pelear	pelear
peligr	peligros	peligros
pen	penas	penas
penal	penales	penal,penales
penaliz	penalizar	penalizar
penalol	peñalolén	peñalolén
pendenc	pendencia	pendencia
pens	pensaban	pensaban,pensando,pensar
pensamient	pensamiento	pensamiento
pension	pensión	pensión
perd	pérdida	perder,perdiendo,pérdida
perenn	perenne	perenne
period	periodos	periodo,periodos,periódicamente,período
perjudic	perjudicar	perjudicar
perjuic	perjuicio	perjuicio
permanent	permanente	permanente
permit	permitirle	permita,permitan,permite,permitido,permitiendo,permitir,permitirle
permitir	permitiría	permitiría
perpetu	perpetuidad	perpetuado,perpetuidad
persegu	perseguir	perseguir
persig	persiguen	persiguen
person	personales	persona,personal,personales,personas
perspect	perspectivas	perspectiva,perspectivas
pertenec	pertenecer	pertenece,pertenecer
pertenecient	pertenecientes	pertenecientes
pertenent	pertenencia	pertenencia
pertenezc	pertenezcan	pertenezcan
pertinent	pertinentes	pertinentes
pes	pesar	pesar
pidcp	pidcp	pidcp
pidesc	pidesc	pidesc
piedr	piedra	piedra
pil	pilar	pilar
pinochet	pinochet	pinochet
plan	planes	planes
planific	planificación	planificación
plant	planteamos	planteamos
plante	plantea	plantea,planteó
planteamient	planteamientos	planteamientos
plasm	plasmándolos	plasmándolos
plat	plata	plata
plaz	plazo	plazo
plebiscit	plebiscitos	plebiscito,plebiscitos
plebiscitoreferendumconsult	plebiscitoreferéndumconsulta	plebiscitoreferéndumconsulta
plen	pleno	plena,plenamente,pleno
plural	pluralistas	plural,pluralidad,pluralismo,pluralista,pluralistas
plurinacion	plurinacionalismo	plurinacionalismo
pobl	población	poblaciones,población
poblacion	poblacional	poblacional
poc	pocos	pocos
pod	podemos	podemos,poder
poder	poderes	poderes
podr	podría	podrá,podría
polariz	polarizada	polarizada
poliitc	políitca	políitca
polit	política	política,políticamente,políticas,político,políticos
pon	ponemos	ponemos,poner,ponerse
pong	ponga	ponga
popul	popular	popular
portador	portador	portador
pos	poseen	pos,posean,poseen
posibil	posibilidades	posibilidad,posibilidades
posibilit	posibilitar	posibilita,posibilitar
posibl	posible	posible
posicion	posición	posición
posit	positivo	positiva,positivamente,positivo
postnat	postnatal	postnatal
postul	postular	postular
potenc	potenciación	potenciación,potencial,potencialidades,potenciar,potencie
practic	prácticas	practica,practicar,práctica,prácticas
practiqu	practiquen	practiquen
prebas	prebásica	prebásica
prec	precariedad	precariedad
precept	preceptos	preceptos
precis	precisar	precisar
preescol	preescolar	preescolar
preferent	preferencias	preferencias
preferir	preferiríamos	preferiríamos
pregunt	pregunta	pregunta
prens	prensa	prensa
preocup	preocupándose	preocupándose
prepar	preparación	preparación
prerrog	prerrogativas	prerrogativas
prescind	prescindir	prescindir
presenc	presencial	presencial
present	presentación	presentación,presentar,presente,presentes
preserv	preservación	preservación,preservando,preservar
presidenc	presidencialismo	presidencial,presidencialismo,presidencialista
presidencialsemipresidenc	presidencialsemipresidencial	presidencialsemipresidencial
president	presidencia	presidencia,presidente
presion	presión	presión
prest	prestación	prestaciones,prestación
presupuest	presupuesto	presupuesto
prev	previas	previa,previas
prevencion	prevención	prevención
prevent	preventivo	preventivo
prevision	previsión	previsión
prim	primaria	primaria,primer
primac	primacía	primacía
primer	primero	primera,primero
princip	principales	principal,principales,principalmente,principio,principios
principiovalor	principiovalor	principiovalor
prinicp	prinicpio	prinicpio
priorid	prioridad	prioridad
prioriz	priorizar	priorizar
priv	privados	privada,privadas,privado,privados
privac	privacidad	privacidad
privileg	privilegiados	privilegiada,privilegiados,privilegiar,privilegio,privilegios
probid	probidad	probidad
problem	problemas	problema,problemas
problemat	problemáticas	problemática,problemáticas
proc	procedimientos	procedimiento,procedimientos
proced	procedió	procedió
proces	procesos	proceso,procesos
proclam	proclamados	proclamados
procur	procure	procure
produc	producimos	producen,producimos
produccion	producción	producción
product	productividad	productividad,productivo,producto
profes	profesan	profesan,profesar
profesion	profesionalizante	profesional,profesionales,profesionalizante,profesión
profund	profundidad	profundidad,profundizar,profundo
program	programa	programa
progres	progreso	progreso
prohib	prohibir	prohibir
proj	prójimos	prójimos
promocion	promoción	promoción
promotor	promotores	promotor,promotores
promov	promoverlos	promovemos,promover,promoverlos,promovido,promoviendo
promuev	promuevan	promueva,promuevan
pronunc	pronunciamiento	pronunciamiento,pronuncie
prop	propiedad	propia,propiamente,propias,propiedad,propio,propios
propend	propender	propende,propender
propens	propenso	propenso
propon	proponemos	propone,proponemos,proponen,proponer
proporcion	proporcionalidad	proporciona,proporcionalidad,proporcionan,proporcionar
proposit	propositivas	propositivas,propositivo
propuest	propuestos	propuesta,propuestas,propuesto,propuestos
propus	propusieron	propusieron,propuso
proscrib	proscribiendo	proscribiendo
protagon	protagónica	protagónica
protex	protección	protección,protege,proteger,protegerlos,protegida,protegidos,protegiendo
protocol	protocolo	protocolo
prov	proveer	proveer
prove	provea	provea
proveyendol	proveyéndoles	proveyéndoles
provinc	provinciales	provincia,provincial,provinciales,provincias
provoc	provoca	provoca,provocando
proxim	próximas	próxima,próximas
proyeccion	proyección	proyecciones,proyección
proyect	proyectos	proyecto,proyectos
psiquic	psíquico	psíquica,psíquico
publ	públias	públias
public	publicidad	publicidad,pública,públicas,público,públicos
pud	pudiendo	pudiendo
puebl	pueblos	pueblo,pueblos
pueblociudadan	pueblociudadano	pueblociudadano
pued	pueden	pueda,puedan,puede,pueden
pues	pues	pues
puest	puestos	puestos
punt	puntos	punto,puntos
puntual	puntuales	puntuales
quebr	quebrarse	quebrado,quebrarse
qued	quedarse	queda,quedado,quedarse,quede,quedó
quedar	quedáramos	quedáramos
quej	quejarse	quejarse
quer	queremos	queremos
quier	quieran	quiera,quieran,quiere,quieren,quiero
quimic	química	química
quis	quisimos	quisimos
quorums	quórums	quórums
racial	raciales	racial,raciales
racion	racionarse	racionarse
radic	radicado	radicado
radical	radicalmente	radicalmente
radiqu	radique	radique
raic	raíces	raíces
ram	ramos	rama,ramas,ramos
rang	rango	rango
ratific	ratificación	ratificación,ratificada,ratificamos
raz	raza	raza
razon	razonables	razonables,razones,razón
real	realización	real,realización
realid	realidad	realidad
realidad	realidades	realidades
realiz	realizado	realiza,realizado,realizan,realizar
rec	recaer	recaer
recaud	recaudación	recaudación
rechac	rechace	rechace
rechaz	rechazamos	rechaza,rechazamos
recib	recibir	reciba,recibir
reciclaj	reciclaje	reciclaje
reciproc	reciprocidad	reciprocidad,recíprocamente,recíproco
reclam	reclamo	reclamo
recobr	recobrará	recobrará
recog	recoger	recoge,recoger
recomend	recomendación	recomendación
reconoc	reconocimiento	reconoce,reconocemos,reconocer,reconociendo,reconocimiento
reconozc	reconozcamos	reconozca,reconozcamos
recort	recortar	recortar
rect	recta	recta
recuper	recuperación	recuperación,recuperada,recuperar,recuperen
recurs	recursos	recursos
redaccion	redacción	redacción
redact	redactada	redactada,redactar
redistribucion	redistribución	redistribución
reeleccion	reelección	reelección
reemplaz	reemplazar	reemplazando,reemplazar,reemplazo
reestructur	reestructurar	reestructurar
refer	referirse	referido,referirse
referenc	referencos	referencos
referend	referendos	referendo,referendos
referendum	referéndum	referéndum
referent	referentes	referentes
refier	refiere	refiere
reflexion	reflexionamos	reflexionamos,reflexión
reflexionas	reflexionásemos	reflexionásemos
reform	reformas	reforma,reformar,reformas
reforz	reforzarla	reforzar,reforzarla
refrend	refrendara	refrendara,refrendará
refuerc	refuerce	refuerce
refund	refundar	refundar
reg	regirnos	regimos,regirnos
regim	regimen	regimen,régimen
region	regionales	regional,regionales,regiones,región
regl	reglas	regla,reglas
regul	regulaciones	regulaciones,regulada,regulado,reguladores,regulados,regular
regular	regularizadas	regularizadas
rehabilit	rehabilitación	rehabilitación
rein	reina	reina,reine
rel	relación	relaciona,relacionado,relacionamos,relacionarnos,relacionarse,relaciones,relación
relev	relevantes	relevada,relevancia,relevante,relevantes
relig	religiosos	religiosa,religiosas,religiosos
religion	religiones	religiones,religión
relocal	relocalización	relocalización
rendicion	rendición	rendición
rent	rentados	rentados
renunc	renuncia	renuncia
replant	replantear	replantear
replic	replicar	replicar
represal	represalias	represalias
represent	representación	representa,representación,representadas,representados,representan,representantes,representar,representativa,representativas,representativo,represente,representen,representándolas
representat	representatividad	representatividad
represion	represión	represión
republ	república	república
requ	requieran	requiera,requieran
requer	requerimientos	requerimientos
requier	requieren	requiere,requieren
requisit	requisitos	requisito,requisitos
reserv	reserva	reserva
resguard	resguardarse	resguarda,resguardada,resguardando,resguardar,resguardarse,resguarde,resguardo
resid	residen	reside,residen
resident	residentes	residencia,residentes
residu	residuos	residuos
resolu	resoluciones	resoluciones
resolucion	resolución	resolución
resolut	resolutivos	resolutiva,resolutivos
resolv	resolvamos	resolvamos,resolviendo
respect	respectivas	respectivas,respectivos,respecto
respet	respetarnos	respeta,respetada,respetadas,respetados,respetando,respetar,respetarla,respetarlas,respetarnos,respete,respeten,respeto
respetoconserv	respetoconservación	respetoconservación
respetu	respetuosos	respetuosas,respetuoso,respetuosos
respond	respondan	respondan,responde,responder
respons	responsabilidades	responsabilidad,responsabilidades,responsable,responsables
responsabil	responsabili	responsabili
respuest	respuesta	respuesta
rest	restar	restar,resto
restring	restringida	restringida
resuelv	resuelve	resuelve
result	resultado	resultado
resum	resumen	resumen
retribu	retribuyó	retribuyó
retribucion	retribución	retribución
retroaliment	retroalimentación	retroalimentación
reun	reunidos	reunido,reunidos,reúna,reúne
reunion	reunión	reunión
revert	revertir	revertir
revis	revisada	revisada,revisar,revisen
revision	revisión	revisión
revoc	revocación	revocación
revocator	revocatorio	revocatorio
riesg	riesgos	riesgo,riesgos
rig	rige	rige
rigor	rigor	rigor
rigur	rigurosidad	rigurosidad
rij	rijan	rijan
riquez	riquezas	riqueza,riquezas
rol	roles	rol,roles
romp	romper	romper
ruid	ruido	ruido
sab	sábado	saber,sábado
sac	saciedad	saciedad
sal	salarios	salario,salarios,salas
salar	salarial	salarial
salt	salto	salto
salud	saludable	salud,saludable
salvaguard	salvaguardar	salvaguarda,salvaguardar
san	sanación	san,sana,sanación,sano
sancion	sanción	sancionado,sancionar,sanciones,sanción
saneamient	saneamiento	saneamiento
santiag	santiago	santiago
satisfac	satisfacer	satisfacer
satisfaccion	satisfacción	satisfacción
satisfag	satisfagan	satisfagan
satisfech	satisfechos	satisfechos
secret	secretas	secretas
sectar	sectarismo	sectarismo
sector	sectores	sector,sectores
sed	sede	sede
segreg	segregadora	segregadora,segregando,segregar
segu	seguido	seguido,seguir
segund	segunda	segunda
segur	seguridad	seguridad,seguro,seguros
seleccion	seleccionados	seleccionados,seleccionaron
sem	semi	semi
semidirect	semidirecta	semidirecta
semipresidenc	semipresidencial	semipresidencial
sen	senado	senado
senal	señalar	señala,señalar
senam	sename	sename
sencill	sencillas	sencillas
sent	sentiremos	sentimos,sentiremos,sentirse
sentenc	sentencia	sentencia
sentimient	sentimiento	sentimiento
separ	separación	separación,separada,separado,separar
ser	serio	ser,seres,seria,serie,serio,será,serán,sería
servic	servicios	servicio,servicios
servidor	servidores	servidores
servir	servirá	servirá
sex	sexo	sexo
sexual	sexuales	sexual,sexuales
sid	sido	sido
siempr	siempre	siempre
siend	siendo	siendo
sient	sienten	sienta,sienten,siento
sig	siguen	sigue,siguen
signif	significa	significa
signific	significativos	significativa,significativos
signifiqu	signifique	signifique
siguient	siguientes	siguiente,siguientes
silvestr	silvestre	silvestre
simbiot	simbiótico	simbiótico
simbol	simbólico	simbólico
similar	similares	similares
simpl	simple	simple
simplific	simplificando	simplificando
sin	sino	sino
sindic	sindicalización	sindicales,sindicalización,sindicalizarse
sindicat	sindicatos	sindicato,sindicatos
sint	sintamos	sintamos
sintesis	síntesis	síntesis
sintet	sintetizan	sintetizan
sirv	sirvió	sirvió
sistem	sistema	sistema
situ	situación	situaciones,situación,situándolos
soberan	soberanía	soberano,soberanía
soc	sociedad	sociedad
social	sociales	social,sociales
sociocultur	socioculturales	socioculturales
socioeconom	socioeconómico	socioeconómico
sol	sólo	sola,solamente,solo,sólo
solid	solidarias	solidaria,solidarias,solidario
solidar	solidaridad	solidaridad
solucion	soluciones	solucionar,soluciones
somet	sometidas	somete,someterse,sometidas,sometido
son	soñamos	soñamos
sosten	sostenibles	sostenible,sostenibles
sostien	sostiene	sostiene
storic	stórica	stórica
subdivision	subdivisiones	subdivisiones
subordin	subordinación	subordinación,subordinadas,subordinarse
subsidiar	subsidiaridad	subsidiaridad
subsist	subsistamos	subsistamos
subsistent	subsistencia	subsistencia
subsistir	subsistirá	subsistirá
subvencion	subvención	subvención
suc	sucede	sucede
sudamer	sudámerica	sudámerica
suel	suele	suele
sueld	sueldos	sueldos
suficient	suficientes	suficiente,suficientes
sufrag	sufragio	sufragio
sujecion	sujeción	sujeción
sujet	sujetos	sujeto,sujetos
sum	sumarse	suma,sumar,sumarse
supedit	supeditación	supeditación
superior	superiores	superior,superiores
supervigil	supervigilar	supervigilar
supervision	supervisión	supervisión
supervisor	supervisor	supervisor
supervivent	supervivencia	supervivencia
supon	supone	supone
suprem	supremo	supremo
supremac	supremacía	supremacía
suprim	suprimir	suprimir
sur	sur	sur
surg	surge	surge
suscit	suscitó	suscitó
suscripcion	suscripción	suscripción
suscrit	suscritos	suscritos
sustant	sustantivas	sustantivas
sustent	sustentabilidad	sustenta,sustentabilidad,sustentable,sustentables,sustentada,sustentadas
tal	tales	tal,tales
talent	talentos	talentos
tamb	también	también
tampoc	tampoco	tampoco
tan	tan	tan
tangibl	tangible	tangible
tant	tantas	tantas
tare	tarea	tarea
tecnic	técnicas	técnica,técnicas,técnico,técnicos
tecnolog	tecnológicas	tecnológicas
television	televisión	televisión
tem	temas	tema,temas
temor	temor	temor
tempor	temporales	temporales
ten	tener	tener
tend	tender	tender
tendenc	tendencia	tendencia
tendr	tendrá	tendrá
terc	terciaria	terciaria
tercer	tercera	tercera
termin	términos	termina,terminar,terminó,término,términos
territor	territorios	territorial,territorio,territorios
text	texto	texto
tiemp	tiempos	tiempo,tiempos
tiend	tienden	tienden
tierr	tierra	tierra
tip	tipos	tipos
tir	tirando	tirando
titul	títulos	título,títulos
tod	todosas	toda,todas,todosas
toler	tolerantes	tolerancia,tolerantes
tom	tomamos	toma,tomada,tomado,tomamos,toman,tomando,tomar,tomas,tomen,tomó
toqu	toque	toque
tot	toti	toti
total	totalidad	total,totalidad
totalit	totalitario	totalitario
trab	trabas	trabas
trabaj	trabajadores	trabaja,trabajadores,trabajar,trabajo
trabajadorempl	trabajadorempleador	trabajadorempleador
tramit	trámites	tramita,trámite,trámites
tranquil	tranquilidad	tranquilidad,tranquilos
trans	transe	transe
transform	transformaciones	transforma,transformaciones,transformar
transit	transitar	transitar
transparent	transparentes	transparencia,transparentar,transparentes
trascend	trascender	trascender
trascendent	trascendencia	trascendencia
trasciend	trascienda	trascienda
traslad	trasladar	trasladar
traspas	traspaso	traspaso,traspasó
trat	tratados	trata,tratado,tratados,tratan,trato,tratos
tratamient	tratamiento	tratamiento
trav	través	través
tres	tres	tres
tribun	tribunales	tribunal,tribunales
tribut	tributarias	tributaria,tributarias
tributosimpuest	tributosimpuestos	tributosimpuestos
tricontinent	tricontinental	tricontinental
turism	turismo	turismo
tutel	tutelados	tutela,tutelados
tutor	tutores	tutores
tuvier	tuviéramos	tuviéramos
ubic	ubicación	ubicación,ubicada
ultim	últimas	última,últimas,último
unanim	unanimidad	unanimidad,unánime
unesc	unesco	unesco
unic	único	unico,única,único
unicamer	unicameral	unicameral
unid	unidas	unidad,unidas,unido
unir	unir	unir
unit	unitario	unitario
univers	universidades	universal,universales,universalidad,universalizar,universidades
urban	urbanización	urbanización
urgent	urgentemente	urgentemente
uso	uso	uso
usu	usuario	usuario
usufruct	usufructo	usufructo
vac	vacía	vacía
val	válidos	valer,valerse,válidos
valid	validan	validan
valios	valioso	valiosa,valioso
valioso	valiosoa	valiosoa
valor	valoramos	valor,valorada,valoramos,valores
valoric	valorice	valorice
valorprincip	valorprincipio	valorprincipio
valparais	valparaíso	valparaíso
vam	vamos	vamos
van	van	van
var	variedad	variedad,varios
vay	vayan	vaya,vayan
vec	veces	veces
vecin	vecinos	vecinos
vecinal	vecinales	vecinales
veget	vegetación	vegetación
vejator	vejatorios	vejatorios
vejez	vejez	vejez
vel	velarse	velando,velar,velarse,vele
vem	vemos	vemos
venider	venideros	venideros
ventaj	ventajas	ventajas
veo	veo	veo
ver	ver	ver
verbal	verbal	verbal
verdader	verdadero	verdadera,verdadero
verid	verídica	verídica
vern	vernos	vernos
vest	vestido	vestido
vet	vetar	vetar
vez	vez	vez
via	vía	vía
vicevers	viceversa	viceversa
vid	vidas	vida,vidas
vien	vienen	viene,vienen
vigenc	vigencia	vigencia
vigent	vigente	vigente
vigil	vigilar	vigilar
vim	vimos	vimos
vincul	vinculación	vinculación,vinculada,vinculado,vinculados,vinculante,vinculantes,vínculo,vínculos
viol	violación	violación,viole
violenc	violencia	violencia
virtud	virtudes	virtudes
vision	visiones	visiones,visión
vist	vistos	vista,vistos
visual	visualizando	visualizando
vital	vital	vital
viudez	viudez	viudez
viv	vivieron	vivan,vive,viven,vivieron,vivimos,vivir,vivos
viviend	vivienda	vivienda
voc	vocaciones	vocaciones
volunt	voluntario	voluntad,voluntariamente,voluntario
vot	votación	votación,votan,votar,votaron,voto
voy	voy	voy
voz	voz	voz
vuelt	vuelto	vuelto
vuelv	vuelva	vuelva
vulner	vulneración	vulnerabilidad,vulnerables,vulneración,vulnerado,vulnerados,vulnerar,vulneren
word	word	word
xxxx	xxxx	xxxx
